S                  sprite.xpm
NO   ./greybrick
SO ./art on wall.XPM
WE  ./redBRICk.xpm
          
EA                    ./swastica.xpm
R 1000            1000
F 86,25,52
C  0,69,25

11111111111111111111111 
10000000000020000000021
10000000000020000000021
100E0000000020000000021
10000000000020000000021
10000000000020000000021
10000000000020000000021
11111111111111111111111 